111111111111111111111111111111111111111111111111111111111111111
1........1....................................................1
1....P...1...........................................1........1
1........1.....M....11111111111111111.........111....1........1
1........1...........................................1........1
1...111111...........................................111111...1
1.............................................................1
1...M.........................................................1
1........111111111111111.....................M................1
1.............................................................1
1.............................................................1
1........11111111111111.......................................1
1.............................................................1
1..........................11111111111111111111111............1
1..........................1..................................1
1......111111..............1..................................1
1..........................1............11111111..............1
1..........................1..................................1
1..........1111111..................................M.........1
1..............................................M..............1
1................................................M............1
1...1.........................................................1
1...1...........1111111111111111111111111.....................1
1...1.........................................................1
1...1.........M...............................................1
1...1......M..................................................1
1...1..................1111111111111111111111111..............1
1...1.........................................................1
1...1.........................................................1
1...1....................................11111111111111.......1
1...1....11111111111111..........MM...........................1
1.............................................................1
1...........................................1111111...........1
1.................................M...........................1
1......1......M........1......................................1
1......1......111......1..............M..........11111........1
1..11111.......M.......11111.....M........M.....1.............1
1.........................................................M...1
111111111111111111111111111111111111111111111111111111111111111
